,.,,,,,,.,,,.,,,,
,,,╔══,══╗.,,,,,,
,,,,+++++║.,,,,,,
,,,║+++.+,,,,,,,,
,,,║.++++║,.,,,,,
,.,║++++.║,,,,,,,
,,,║+++++,,,,,,,,
,,,,══+══╝,,,,,,,
,.,,,,,,,,,.,,,,,
,,,,,,.,,.,,,,,,,
,,,,,,.,,.,,,,,,,
,,,,,,.,,.,,,,,,,
,,,,,,.,,.,,,,,,,