,.,,,,,,.,,,.
,,,╔══,══╗.,,
,,,,+++++║.,,
,,,║+++.+,,,,
,,,║.++++║,.,
,.,║++++.║,,,
,,,║+++++,,,,
,,,,══+══╝,,,
,.,,,,,,,,,.,
,,,,,,X,,.,,,