,,,,,,,,,,,,,
,,,╔═════╗,,,
,,,║+++++║,,,
,,,║+++++║,,,
,,,║+++++║,,,
,,,║+++++║,,,
,,,║+++++║,,,
,,,╚══+══╝,,,
,,,,,,,,,,,,,
,,,,,,X,,,,,,